10 10
512 512
7 3 16 16 16 16 3 3 3 8
4 0 0 0 0 0 11 0 14 5
4 0 0 0 0 0 13 0 15 5
4 0 0 0 0 0 11 0 0 5
4 0 0 0 0 0 11 13 12 5
4 0 0 0 0 0 11 0 0 5
4 0 0 0 0 0 13 0 0 5
4 0 0 0 0 0 11 0 0 5
4 0 0 0 0 0 11 0 0 5
9 6 6 6 6 6 6 6 13 10
